# 铁锈战争 MOD 翻译库
# 自动生成于 翻译分类结果.txt
# 格式: 英文 = 中文
# Section格式: [英文] = [中文]

# ================================================================================
# Section 翻译
# ================================================================================
[ai] = [AI]
[attack] = [攻击]
[core] = [核心]
[graphics] = [图像]
[movement] = [移动]
[hiddenAction_ = [隐藏行动_

# ================================================================================
# Value 特殊值翻译 (布尔值、枚举值等)
# ================================================================================
AIR = 空军
BUILDING = 建筑
HOVER = 两栖
LAND = 陆地
NONE = 无
OVER_CLIFF = 跨悬崖
OVER_CLIFF_WATER = 跨悬崖和水
WATER = 水

# ================================================================================
# Key 翻译
# ================================================================================
@copyFromSection = 复制节
@copyFrom_skipThisSection = 复制但跳过节
KeyframeTimeScale = 帧时长缩放
Section = 效果
activeWaypointTarget = 活动路径点目标
addActionCooldownApplyToActions = 添加指定动作冷却时间
addActionCooldownTime = 增加动作冷却时间
addAllActionCooldownsTime = 增加所有动作冷却时间
addEnergy = 增加能量
addGlobalTeamTags = 添加全局标签
addResources = 增加资源
addResourcesScaledByAIHandicaps = 根据AI难度添加资源
addResourcesWithLogic = 用逻辑添加资源
addTransportedUnits = 增加被运输单位
addUnitsIntoTransport = 添加单位到载具
addWaypoint_maxTime = 添加路径点检索时间
addWaypoint_position_fromAction = 添加路径点动作坐标
addWaypoint_position_offsetFromSelf = 添加路径点坐标偏移
addWaypoint_position_randomOffsetFromSelf = 添加路径点随机偏移
addWaypoint_position_relativeOffsetFromSelf = 添加路径点相对偏移
addWaypoint_prepend = 添加路径点序列位置
addWaypoint_target_fromReference = 添加路径点来自参考
addWaypoint_target_mapMustBeReachable = 添加路径点路径可达
addWaypoint_target_nearestUnit_maxRange = 添加路径点检索范围
addWaypoint_target_nearestUnit_tagged = 添加路径点检索标签
addWaypoint_target_nearestUnit_team = 添加路径点靠近队伍
addWaypoint_target_randomUnit_maxRange = 添加指定范围的随机单位
addWaypoint_target_randomUnit_tagged = 添加指定标签的随机单位
addWaypoint_target_randomUnit_team = 添加指定队伍的随机单位
addWaypoint_triggerActionIfFailed = 添加路径点失败触发
addWaypoint_triggerActionIfMatched = 添加路径点匹配触发
addWaypoint_type = 添加路径点动作类型
addWaypoint_unitType = 添加路径点单位类型
ai_considerSameAsBuilding = AI作为建筑
ai_isDisabled = AI被禁用
ai_isHighPriority = AI高优先级
ai_upgradePriority = AI升级优先级
aimOffsetSpread = 瞄准偏移
allowCaptureWhenNeutralByAI = 允许中立时被AI俘虏
allowMultipleInQueue = 允许多个队列
ally = 盟友
allyNotOwn = 除自己外盟友
alpha = 透明度
alsoEmitEffects = 也创造效果
alsoEmitEffectsOnDeath = 死亡时创建效果
alsoPlaySound = 也播放音效
alsoQueueAction = 也添加进队列
alsoTriggerAction = 也执行动作
alsoTriggerOrQueueActionConditional = 也执行队列或需执行条件
altNames = 别名
altProjectile = 关联抛射体
altProjectileCondition = 关联抛射体条件
alwayStartDirAtZero = 朝向总是零度
alwaysAllowedToAttackParentsMainTarget = 总是攻击父单位的主要目标
alwaysSinglePress = 总是按一次
alwaysStartDirAtZero = 固定角度为零
alwaysStartHeightAtZero = 固定高度为零
alwaysVisibleInFog = 迷雾中显示
animateFrameEnd = 动画结束帧
animateFrameLooping = 动画帧循环
animateFramePingPong = 动画帧重放
animateFrameSpeed = 动画帧速度
animateFrameSpeedRandom = 动画帧随机速度
animateFrameStart = 动画开始帧
animation_TYPE_end = 动画_类型_结束
animation_TYPE_pingPong = 动画_类型_膨胀
animation_TYPE_scale_end = 动画_类型_缩放结束
animation_TYPE_scale_start = 动画_类型_缩放开始
animation_TYPE_speed = 动画_类型_速度
animation_TYPE_start = 动画_类型_开始
anyRuleInGroup = 放置规则组
areaDamage = 范围伤害
areaDamageNoFalloff = 范围伤害不衰减
areaExpandTime = 范围扩展时间
areaHitAirAndLandAtSameTime = 范围武器同时攻击空中和地面
areaHitUnderwaterAlways = 范围武器可攻击深海
areaIgnoreUnitsCloserThan = 范围伤害忽略区域
areaRadius = 范围半径
areaRadiusFromEdge = 范围伤害从边缘计算
armour = 装甲
armourIgnoreAmount = 无视装甲数量
armourMinDamageToKeep = 装甲最低伤害
atmospheric = 空气效果
attach_x = x轴链接位置
attach_y = Y轴链接位置
attachedTo = 链接到
attachedToUnit = 附着在单位上
attachment = 附件
attachments_addNewUnits = 附属添加单位
attachments_deleteNumUnits = 附属删除单位数
attachments_disconnect = 附属断开连接
attachments_onlyOnSlots = 附属添加于槽位
attachments_unload = 卸载附属
attackMovement = 攻击移动类型
attacking = 攻击
autoRepair = 可以自动修
autoTargetingOnDeadTarget = 自动切换目标
autoTargetingOnDeadTargetLead = 自动切换目标预判
autoTargetingOnDeadTargetRange = 自动切换目标检索范围
autoTrigger = 自动触发
autoTriggerCheckRate = 自动触发检查率
autoTriggerCooldownTime = 自动触发间隔
autoTriggerCooldownTime_allowDangerousHighCPU = 允许超高频触发
autoTriggerOnEvent = 自动触发事件
ballistic = 弹道
ballistic_delaymove_height = 弹道垂直飞行高度
ballistic_height = 弹道高度
barrelHeight = 炮弹高度
barrelOffsetX_onOddShots = 奇数射击时炮弹偏移
barrelX = 炮弹x
barrelY = 炮弹y
basePosition = 中心位置
basePositionFromLeg = 指定脚为中心位置
basePositionFromTurret = 指定炮塔为中心位置
beamImage = 波束图像
beamImageEnd = 波束命中图像
beamImageEndRotated = 波束末端旋转
beamImageOffsetRate = 波束偏移频率
beamImageStart = 波束开始图像
beamImageStartRotated = 波束始端旋转
blendIn = 融入时间
blendOut = 切换融合
blocksPlacement = 禁止放置
borrowResourcesWhileAlive = 资源活着时借用
buildPriority = 建造优先级
buildSpeed = 建造速度
buildingDamageMultiplier = 建筑伤害乘数
buildingSelectionOffset = 建筑UI调整
buildingToFootprintOffsetX = 建筑X轴偏移
buildingToFootprintOffsetY = 建筑Y轴偏移
canAttack = 可攻击
canAttackCondition = 攻击条件
canAttackFlyingUnits = 可攻击空中单位
canAttackLandUnits = 可攻击表面单位
canAttackMaxAngle = 可攻击最大角度
canAttackNotTouchingWaterUnits = 可以攻击非接触水单位
canAttackUnderwaterUnits = 可攻击水下单位
canBeAttackedAndDamaged = 可被攻击或损坏
canNotBeDamaged = 禁止受到伤害
canNotBeDirectlyAttacked = 禁止直接攻击
canNotBeGivenOrdersByPlayer = 禁止接受指令
canOnlyAttackUnitsWithTags = 只攻击带特定标签单位
canOnlyAttackUnitsWithoutTags = 不攻击带特定标签单位
canOnlyBeAttackedByUnitsWithTags = 仅许带此标签单位攻击
canPlayerCancel = 玩家可以取消
canReclaimResources = 可以回收资源
canReclaimResourcesNextSearchRange = 搜寻资源范围
canReclaimResourcesOnlyWithTags = 仅允许回收特定标签资源
canReclaimUnitsOnlyWithTags = 仅允许回收特定标签单位
canRepairBuildings = 可以修建筑
canRepairUnits = 可以修单位
canRepairUnitsOnlyWithTags = 仅允许维修特定标签单位
canShoot = 可以开火
cannotPlaceMessage = 失败信息
checkEachTile = 检查每个地块
clearActiveWaypoint = 清除当前路径点
clearAllActionCooldowns = 清除所有动作冷却时间
clearAllWaypoints = 清除所有路径点
clearTurretTargetAfterFiring = 射击后重置炮塔目标
color = 颜色
constructionFootprint = 建筑覆盖范围
convertHitToSourceTeam = 命中时更改所属
convertResource_from = 转换资源来源
convertResource_maxAmount = 转换资源至多
convertResource_minAmount = 转换资源至少
convertResource_multiplyAmountBy = 转换资源倍率
convertResource_to = 转换资源至
convertTo = 转换成
convertToNeutralIfNotTransporting = 卸载所有单位时恢复为中立
convertTo_keepCurrentFields = 转换时保留字段
convertTo_keepCurrentTags = 转换时保留标签
copyFrom = 复制与
copyWaypointsFrom = 复制路径来自
createIncompleteIfParentIs = 创建随父单位
createNeutral = 创建时中立
createOnAggressiveTeam = 创建为敌对中立
createWhenOffscreen = 可创建于画面之外
createWhenOverLand = 创建于陆地上
createWhenOverLiquid = 创建于液体上
createWhenZoomedOut = 缩小时可产生效果
credits = 资金
customTarget1 = 自定义目标1
customTarget2 = 自定义目标2
damagingBorder = 伤害边框
deattachIfWantingToMove = 移动时脱离
debugMessage = 排错信息
defineUnitMemory = 定义单位内存
deflectionPower = 激光拦截耗能
delay = 开火间隔
delayedStartTimer = 延迟创建
delayedStartTimerRandom = 延迟创建随机时间
deleteNumUnitsFromTransport = 从载具中删除单位数
deleteNumUnitsFromTransport_onlyWithTags = 从载具删除带标签单位
deleteSelf = 删除自身
description = 描述
descriptionAddFromUnit = 从单元添加描述
descriptionAddUnitStats = 从单元添加属性
dieOnAttack = 自杀攻击
dieOnConstruct = 构建时死亡
dieOnZeroEnergy = 无能量时死亡
dirOffset = 角度偏移
dirOffsetRandom = 随机角度偏移量
dirSpeed = 转速
dirSpeedRandom = 随机转速
directDamage = 直接伤害
direction_starting = 多向动画朝向
direction_strideX = 多向动画x向
direction_strideY = 多向动画y向
direction_units = 多向动画度数
disableAllUnitCollisions = 禁用碰撞
disableDeathOnZeroHp = 禁用零血死亡
disableLeadTargeting = 禁用预判
disableLowHpFire = 禁用低生命冒火
disableLowHpSmoke = 禁用低生命冒烟
disablePassiveTargeting = 不能主动攻击
disableUse = 禁用
disconnectFromParent = 脱离父单位
displayColor = 显示颜色
displayDescription = 界面显示描述
displayDigitGrouping = 资源数字分组
displayFootprint = 建筑选择UI
displayLocaleKey = 界面显示内部调用
displayName = 显示名称
displayNameShort = 显示短名称
displayRadius = 单位选择时显示圆圈
displayRemainingStockpile = 显示剩余库存
displayRoundedDown = 显示为整数
displayText = 界面显示名称
displayType = 显示类型
displayWhenZero = 为零时显示
distance = 距离
distanceSquared = 距离方差
dont_load = 禁止加载
drawDirOffset = 绘制角度偏移
drawFootWhenZoomedOut = 缩小时绘制脚
drawLegWhenZoomedOut = 缩小时绘制腿
drawLineTo = 绘制线条
drawOverBody = 绘制主体之上
drawSize = 绘制大小
drawType = 作图类型
drawUnderAllUnits = 绘制所有单位之下
drawUnderUnits = 绘制在单位下方
draw_foot_on_top = 绘制脚在顶层
dustEffectReverse = 逆向灰尘效果
dust_effect = 灰尘效果
effectOnCreate = 创建时效果
effectOnDeath = 死亡效果
effectOnDeathGroundCollision = 死亡撞击地面效果
effectOnDeathIfUnbuilt = 没建造完成时死亡效果
empty = 空
endDirOffset = 末端角度偏移值
enemy = 敌人
energy = 能量
energyMax = 能量值
energyNeedsToRechargeToFull = 能量需要充满
energyRegen = 能量恢复速度
energyRegenWhenRecharging = 充能时能量恢复速度
energyStartingPercentage = 能量初始百分比
energyUsage = 能量需求
equalTo = 等于
equivalentGlobalResourceForAI = 作为AI的全局资源
estimatingPositionMultiplier = 预测位置乘数
eventSource = 事件来源
excludeIncompleteBuildings = 排除不完整建筑
excludeNonBuildings = 排除非建筑
exitHeightIgnoreParent = 离开高度忽略父单位
exit_dirOffset = 离开旋转角度
exit_heightOffset = 离开高度
exit_moveAwayAmount = 离开距离
exit_x = 离开x轴
exit_y = 离开y轴
experimental = 实验单位标志
explodeEffect = 爆炸效果
explodeEffectOnShield = 护盾上爆炸效果
explodeOnDeath = 死亡爆炸
explodeOnDeathGroundCollision = 死亡撞击地面爆炸
explodeOnEndOfLife = 寿终爆炸
explodeTypeOnDeath = 死亡时爆炸类型
extraBuildRangeWhenBuildingThis = 额外建造距离
factoryQueue = 包含队列中的
fadeInTime = 淡入时间
fadeOut = 淡出
fallingAcceleration = 降落加速度
fallingAccelerationDead = 坠毁加速度
favourOppositeSideNeighbours = 偏向于临近一侧
finishPlayingLastAnimation = 完成最会动画
fireTurretXAtGround = 指定攻击地面炮塔
fireTurretXAtGround_count = 指定攻击地面数量
fireTurretXAtGround_onlyOverPassableTileOf = 指定攻击地面类型
fireTurretXAtGround_withOffset = 指定攻击地面坐标
fireTurretXAtGround_withProjectile = 指定攻击地面抛射体
fireTurretXAtGround_withTarget = 指定攻击目标
fireTurretXAtSelfOnDeath = 死亡武器
flameWeapon = 火焰武器
fogOfWarSightRange = 视野
fogOfWarSightRangeWhileNotBuilt = 未完成时视野
footprint = 建筑碰撞范围
forceNano = 建造方式
forceUnloadTransportNow = 强制卸载单位
forceUnloadTransportNow_onlyOnSlot = 强制卸载指定槽位单位
frame = 帧
frameIndex = 帧索引
frameIndexRandom = 帧随机
frame_height = 帧高度
frame_width = 帧宽度
friendlyFire = 友伤
full = 满
generation_active = 资源取得条件
generation_credits = 资金获取
generation_delay = 资金获取时间
generation_resources = 资源获取
getAsMarker = 获取为标记
getOffsetAbsolute = 获取绝对偏移
getOffsetRelative = 获取相对偏移
globalMessage_textColor = 信息颜色
globalScale = 全局缩放
globalSearchForFirstUnit = 全局检查第一个单位
gravity = 重力
greaterThan = 超过
gridAlign = 对齐网格
guiBuildUnit = 界面显示单位
hOffset = 高度偏移
hOffsetRandom = 随机高度偏移
hSpeed = 高度速度
hSpeedRandom = 随机高度速度偏移
hardLimit = 硬性限制
hasFlag = 拥有标志
hasMissingFlag = 没有标志
height = 高度
heightChangeRate = 高度改变速率
hidden = 隐藏
hideScorchMark = 死亡痕迹
highPriorityQueue = 高优先级队列
hitSound = 打击音效
holdDisMax = 最大移动距离
holdDisMin = 最小移动距离
holdDisMin_checkNeighbours = 最小移动距离检查相邻
holdDisMin_maxMovingLegs = 最大移动腿数目
hold_moveOnlyIfFurthest = 只在最远时保持移动
hullDamageMultiplier = 护盾损伤乘数
iconExtraColor = 额外图标颜色
iconExtraImage = 额外图标图像
iconExtraIsVisible = 额外图标显示条件
iconImage = 图标
icon_zoomed_out = 缩放图标
icon_zoomed_out_neverShow = 缩放图标永不显示
idleDir = 闲置方向
idleDirReversing = 闲置方向反转
idleSpin = 闲时转速
idleSweepAddRandomAngle = 空闲扫描随机角度
idleSweepAddRandomDelay = 空闲扫描随机延迟
idleSweepAngle = 空闲扫描角度
idleSweepCondition = 空闲扫描条件
idleSweepDelay = 空闲扫描延迟
idleSweepSpeed = 空闲扫描速度
ifSpawnFailsEmitEffects = 如果失败则创建效果
ignoreInUnitCapCalculation = 不计入单位数量统计
ignoreParentShootDamageMultiplier = 忽略父单位射击伤害乘数
imageScale = 图像缩放
imageScaleX = 图像X缩放
imageScaleY = 图像Y缩放
imageStack = 列表图像列表
image_applyTeamColors = 图像应用队伍颜色
image_back = 背景图像
image_drawOffsetX = 图像绘制偏移x
image_drawOffsetY = 图像绘制偏移y
image_end = 末端图像
image_end_shadow = 末端图像阴影
image_end_teamColors = 末端图像着色
image_floatingPointSize = 奇数大小的图像像素调整
image_foot = 脚图像
image_foot_shadow = 脚图像阴影
image_leg = 腿图像
image_middle = 中部图像
image_offsetH = 高度绘制偏移
image_offsetX = 图像X轴偏移
image_offsetY = 图像Y轴偏移
image_shadow_frames = 阴影图像指定
image_shield = 护盾图像
image_turret = 炮塔图像
image_wreak = 死亡图像
includeParentsSelection = 包含父单位选中绘制
includes = 包含标签
incompleteBuildings = 包含未完成的
initialUnguidedSpeedHeight = 初始非制导垂直速度
initialUnguidedSpeedX = 初非导引速度X
initialUnguidedSpeedY = 初非导引速度Y
instant = 瞬间命中
instantReuseLast = 瞬间命中回收最后抛射体
instantReuseLast_alsoChangeTurretAim = 命中回收抛射体且改变瞄准
instantReuseLast_keepAreaDamageList = 命中回收抛射体区域伤害列表
interceptProjectile_removeTargetLifeOnly = 拦截抛射体移除目标存活时间
interceptProjectiles_andOverHeight = 拦截抛射体高度
interceptProjectiles_andTargetingGroundUnderDistance = 拦截抛射体检索范围
interceptProjectiles_andUnderDistance = 拦截抛射体攻击范围
interceptProjectiles_withTags = 拦截抛射体需有标签
invisible = 不可见
isActive = 可用
isAlsoViewableByAllies = 显示给盟友
isAlsoViewableByEnemies = 显示给敌人
isBio = 是生物
isBug = 是虫子
isBuilder = 是建造者
isBuilding = 是建筑
isFixedFiring = 固定射击
isGuiBlinking = 界面闪烁
isLocked = 锁定
isLockedAlt = 更多锁定
isLockedAlt2 = 更多锁定2
isLockedAlt2Message = 更多锁定消息2
isLockedAltMessage = 更多锁定消息
isLockedIfGameModeNoNuke = 禁核模式锁定
isLockedMessage = 锁定消息
isMainNanoTurret = 是主构建炮塔
isMelee = 近战
isPickableStartingUnit = 为可选初始单位
isUnrepairableUnit = 禁止被修复
isUnselectable = 不可选择
isUnselectableAsTarget = 禁止选择和作为目标
isVisible = 可见性
isVisibleToEnemies = 对敌人可见
joinsGroupFormations = 加入队形
keepAliveWhenParentDies = 保持子存活
keepWaypointsNeedingMovement = 保持需要移动路径点
landOnGround = 降落到地面
largeHitEffect = 大的打击效果
laserDefenceEnergyUse = 激光防御能量需求
laserEffect = 激光效果
lastDamagedBy = 最后伤害源
laterThanSeconds = 指定时间后
layer = 绘制图层
leadTargetingSpeedCalculation = 预判计算
lessThan = 少于
life = 效果存在时间
lifeRandom = 效果存在时间随机值
lightCastOnGround = 闪光映射到地面
lightColor = 闪光颜色
lightSize = 闪光大小
lightingEffect = 闪电效果
limitingAngle = 限制角度
limitingMinRange = 最小距离
limitingRange = 限制范围
lineWidth = 线宽度
linkDelayWithTurret = 链接间隔
liveAfterAttachedDies = 目标死后存活
lockLegMovement = 锁定腿脚运动
lockMovement = 锁定运动
lockRotation = 锁定旋转
lock_body_rotation_with_main_turret = 锁定主体旋转随主炮塔
lock_leg_rotation_with_main_turret = 锁定腿脚旋转随主炮塔
lock_shadow_rotation_with_main_turret = 阴影锁定为主炮塔方向
lowPriorityTargetForOtherUnits = 低优先级目标
mass = 质量
maxAttackRange = 攻击距离
maxCount = 最大数量
maxEachBase = 每个基地最大数量
maxGlobal = 全图最大数量
maxHp = 生命值
maxShield = 护盾值
maxSpawnLimit = 最大产生限制
maxTransportingUnits = 运输槽位数量
meleeEngangementDistance = 近战索敌距离
memory= 内存
minCount = 最小数量
moveAccelerationSpeed = 加速度
moveDecelerationSpeed = 减速度
moveIgnoringBody = 移动忽略转向
moveSlidingDir = 移动滑动角度
moveSlidingMode = 移动后滑动
moveSpeed = 移动速度
moveWarmUp = 移动延迟
moveWithParent = 随父物体移动
movementEffect = 运动效果
movementEffectRate = 运动效果频率
movementEffectReverse = 逆向运动效果
movementEffectReverseFlipEffects = 逆向时反转运动效果
movementType = 运动类型
mutatorX_addResourcesAreaHit = 修正区域添加资源
mutatorX_addResourcesDirectHit = 修正直接添加资源
mutatorX_areaDamageMultiplier = 修正范围伤害
mutatorX_changedExplodeEffect = 修正命中效果
mutatorX_directDamageMultiplier = 修正直接伤害
mutatorX_ifUnitWithTags = 修正需要标签
mutatorX_ifUnitWithoutTags = 修正除此标签
nanoFactorySpeed = 工厂速度乘数
nanoRange = 维修或建造范围
nanoRangeForReclaim = 回收距离
nanoRangeForReclaimIsMelee = 回收范围按近战逻辑
nanoRangeForRepair = 维修距离
nanoRangeForRepairIsMelee = 维修范围按近战逻辑
nanoRepairSpeed = 维修速度
nearestUnit = 接近单位
neutral = 中立
noneGlobalExtraPriority = 全图没有时优先级
noneInBaseExtraPriority = 基地内没有时优先级
not = 否
notPassivelyTargetedByOtherUnits = 不被动地被其他单位瞄准
nukeOnDeath = 死亡核爆
nukeOnDeathDamage = 死亡核爆伤害
nukeOnDeathDisableWhenNoNuke = 死亡核爆条件
nukeOnDeathRange = 死亡核爆范围
nukeWeapon = 核武器
nullUnit = 空单位
numBitsOnDeath = 死亡产生碎片
numberOfUnitsInAggressiveTeam = 敌对中立拥有此单位数量
numberOfUnitsInEnemyTeam = 敌人有此单位数量
numberOfUnitsInNeutralTeam = 中立有此单位数量
numberOfUnitsInTeam = 队伍中此单位数量
offsetDir = 偏移角度
offsetHeight = 偏移高度
offsetRandomDir = 偏移随机角度
offsetRandomX = 偏移随机X
offsetRandomXY = 偏移随机XY
offsetRandomY = 偏移随机Y
offsetSelfAbsolute = 自身位置偏移
offsetX = 偏移量x
offsetY = 偏移量y
onActions = 动画条件
onActionsQueuedUnitPlayAt = 在队列中有单位播放
onCreateSpawnUnitOf = 创建时生成单位
onNewMapSpawn = 地图位置产生指定单位
onParentTeamChangeKeepCurrentTeam = 改变队伍时子单位保持原队伍
onShoot_freezeBodyMovementFor = 开火冻结移动
onShoot_playAnimation = 开火播放动画
onShoot_triggerActions = 开火触发行为
onlyInPreview = 侧边栏和建筑放置预览中显示
onlyOnNonPreview = 仅在非预览中显示
onlyOneUnitAtATime = 一次只有一个单位
onlyPlayersWithUnitControl = 使用者能够控制此单位时绘制
onlyTeam = 查看者为特定队伍时显示
onlyUseAsHarvester_ifBaseHasUnitTagged = 有此标签才作为采集者
onlyWhenSelectedByAllyNotOwnPlayer = 自身队伍的盟友选中时绘制
onlyWhenSelectedByAnyPlayer = 任意玩家选中时绘制
onlyWhenSelectedByEnemyPlayer = 敌方玩家选中时绘制
onlyWhenSelectedByOwnPlayer = 我方队伍选中时绘制
onlyWhileActive = 单位建造完成时绘制
onlyWhileAlive = 存活时绘制
onlyWithZoomLevelOrMore = 缩放到当前大小或更大时绘制
order = 排序
overrideAndReplace = 覆盖单位
own = 己方
parent = 父单位
physics = 物理效果
physicsGravity = 物理重力
pingPong = 缩放效果
pivotOffset = 坐标系旋转
pivotOffsetRandom = 枢轴偏移随机
placeOnlyOnResPool = 建筑只能建造在资源池上
playAnimation = 播放动画
playAnimationIfNotPlaying = 播放动画限制
playSoundAtUnit = 播放声音至单位
playSoundGlobally = 播放声音至全图
playSoundToPlayer = 播放声音至玩家
playSoundToPlayerOnQueue = 队列播放声音
pos = 位置
price = 价格
prioritizeParentsMainTarget = 优先考虑父单位的主要目标
priority = 优先级
produceUnits = 生产单位
projectile = 抛射体
pushForce = 推动力量
pushVelocity = 推进速度
radius = 半径
reclaimEffect = 回收效果
reclaimEffectAtTarget = 回收目标效果
reclaimEffectRate = 回收效果频率
reclaimPrice = 回收价格
recoilOffset = 后坐力大小
recoilOutTime = 后坐力速度
recoilReturnTime = 后坐力恢复
recommendedInEachBaseNum = 推荐在每个基地的数量
recommendedInEachBasePriorityIfUnmet = 推荐条件不满足时优先级
recursionLimit = 递归限制
redirectDamageToParent = 重定向伤害到父单位
redirectDamageToParent_shieldOnly = 重定向伤害到父单位护盾
removeGlobalTeamTags = 移除全局标签
repairEffect = 维修效果
repairEffectAtTarget = 维修目标效果
repairEffectRate = 维修效果频率
requireConditional = 需要条件
resetAngle = 复位角度
resetCustomTimer = 重置自定义计时器
resetRotationWhenNotAttacking = 不攻击时重置角度
resetToDefaultTags = 标签重置
resetUnitStats = 恢复单位状态
resourceAmount = 资源类型
resourceAmount_addOtherResource = 资源类型添加至
resourceAmount_multiplyBy = 资源类型乘数
resourceAmount_setValue = 资源类型设置数值
resourceMaxConcurrentReclaimingThis = 可同时被此数目单位回收
resourceRate = 回收速率
resourceUsage = 资源需求
retargetingInFlight = 重新瞄准在飞行时
retargetingInFlightSearchDelay = 重新瞄准在飞行时搜索延迟
retargetingInFlightSearchLead = 重新瞄准在飞行时预判
retargetingInFlightSearchOnlyTags = 重新瞄准在飞行时针对标签
retargetingInFlightSearchRange = 重新瞄准在飞行时搜索范围
reverseSpeedPercentage = 倒车速度比率
rotateSpeed = 旋转速度
rotateWithParent = 子单位一同旋转
rotate_with_direction = 随角度旋转
scaleFrom = 初始缩放倍数
scaleImagesTo = 缩放图像到
scaleTo = 结束缩放倍数
scaleTurretImagesTo = 炮塔图像缩放
scale_end = 缩放结束
scale_start = 缩放开始
searchDistance = 搜索距离
searchOffsetX = 检索偏移x
searchOffsetY = 检索偏移y
searchTags = 检索标签
searchTeam = 检索队伍
self.ammo = 自身弹药
self.ammoIncludingQueued = 自身弹药包括队列
self.builtAmount = 自身建造数量
self.completed = 自身建造完成
self.customTimer = 自身自定义计时器
self.dir = 自身角度
self.energy = 自身能量
self.energyIncludingQueued = 自身能量包括队列
self.globalTeamTags = 有全局标签
self.hasActiveWaypoint = 自身有活动的路径点
self.hasFlag = 自身有标志
self.hasParent = 自身有父单位
self.hasResources = 自身有资源
self.hasTakenDamage = 受到伤害
self.hasUnitInTeam = 自身队伍有单位
self.height = 自身高度
self.hp = 自身血量
self.isAmmoEmpty = 自身弹药空
self.isAtGroundHeight = 自身在地面高度
self.isAtTopSpeed = 自身到最高速度
self.isAttacking = 自身在攻击
self.isControlledByAI = 自身属于AI控制
self.isEnergyEmpty = 自身护盾空
self.isEnergyFull = 自身护盾满
self.isFlying = 自身在天上
self.isInWater = 自身在水中
self.isMoving = 自身在移动
self.isOnNeutralTeam = 自身在中立队伍
self.isOverClift = 自身在悬崖上
self.isOverLiquid = 自身在液体上
self.isOverOpenLand = 自身在开阔地带
self.isOverPassableTile = 自身在地块类型上
self.isOverwater = 自身在水上
self.isResourceLargerThan = 自身资源大于
self.isUnderwater = 自身在水下
self.kills = 自身杀敌数
self.lastConverted = 最后转换时间
self.maxMoveSpeed = 自身最大移动速度
self.noUnitInTeam = 自身队伍无单位
self.numberOfAttachedUnits = 自身有子单位
self.numberOfUnitsInAllyNotOwnTeam = 盟友有此单位数量
self.priceCredits = 自身资源价格
self.queueSize = 自身队列量
self.readUnitMemory = 读取单位内存
self.resource = 自身资源
self.resource.RESOURCE_TYPE = 自身资源类型
self.shield = 自身护盾
self.speed = 自身速度
self.tags = 自身有标签
self.teamDefeatedTech = 队伍失败
self.teamId = 自身队伍id
self.teamVictory = 队伍获胜
self.teamWipedOut = 队伍无单位
self.timeAlive = 存活时间
self.transportingCount = 自身运输数量
self.transportingUnitWithTags = 自身运输单位有标签
selfBuildRate = 自动建造速度
selfRegenRate = 生命恢复速度
setBodyRotation = 设置身体旋转
setBuilt = 设置完成度
setDrawLayerOnBottom = 绘制于底层
setDrawLayerOnTop = 绘制于顶层
setFlag = 设置标志
setResourcesWithLogic = 用逻辑设置资源
setToTeamOfLastAttacker = 所属攻击者
setUnitMemory = 设置单位内存
setUnitStats = 设置单位状态
shadow = 阴影
shadowImage = 阴影图像
shadowOffsetX = X轴阴影偏移
shadowOffsetY = Y轴阴影偏移
shield = 护盾
shieldDamageMultiplier = 护盾伤害乘数
shieldDefectionMultiplier = 护盾阻挡乘数
shieldDeflectionDisplayRate = 护盾消失速度
shieldDisplayOnlyDeflection = 护盾只在受攻击时显示
shieldRegen = 护盾恢复速度
shieldRenderRadius = 单位护盾显示半径
shootDamageMultiplier = 开火伤害乘数
shootDelay = 攻击间隔
shootDelayMultiplier = 开火间隔乘数
shoot_flame = 开火动画
shoot_light = 开火闪光
shoot_sound = 开火音效
shoot_sound_vol = 开火音效大小
shouldResetTurret = 空闲自动归位
shouldRevealFog = 揭开迷雾
showActionsWithMixedSelectionIfOtherUnitsHaveTag = 混合所选单位所显示的行为
showAllActionsFrom = 显示所有操作来源
showEnergyBar = 显示能量条
showHealthBar = 显示生命条
showInEditor = 显示在沙盒中
showInFog = 在雾中显示
showMessageToAllEnemyPlayers = 发送消息给所有敌人
showMessageToAllPlayers = 发送消息至所有
showMessageToPlayer = 发送消息至玩家
showOnMinimap = 显示在小地图上
showOnMinimapToEnemies = 显示于敌人小地图
showQueueBar = 显示队列条
showQuickWarLogToAllPlayers = 发送战争快报至所有
showQuickWarLogToPlayer = 发送战争快报至玩家
showRangeUIGuide = 显示范围UI
showSelectionIndicator = 显示选择指示
showShieldBar = 显示护盾条
showTransportBar = 显示运输条
similarResourcesHaveTag = 像用于此标签的单位
skipIfOverlapping = 跳过条件
slave = 隶属
slowDeathFall = 死亡缓慢降落
smoothlyBlendPositionWhenExistingUnitAdded = 补充时平滑移动
softCollisionOnAll = 碰撞体积软化
soundOnAttackOrder = 攻击指令音效
soundOnDeath = 死亡音效
soundOnMoveOrder = 移动指令音效
soundOnNewSelection = 选择指令音效
spawnChance = 产生机会
spawnEffects = 产生效果
spawnEffectsOnQueue = 队列产生效果
spawnProjectilesOnCreate = 在创建时刷抛射体
spawnProjectilesOnEndOfLife = 在寿命结束时刷抛射体
spawnProjectilesOnExplode = 在爆炸时刷抛射体
spawnUnits = 产生单位
speed = 速度
speedSpread = 速度散布
splastEffect = 水波效果
splastEffectReverse = 逆向水波效果
stack_drawInReverseOrder = 列表图像绘图顺序
stack_frameOffset = 列表图像帧偏移
stack_hOffset = 列表图像高度偏移
stack_indexCount = 列表图像数量
stack_indexStart = 列表图像起始图像
startFallingWhenStartingUnit = 为可选单位开局后从天而降
startShieldAtZero = 护盾初始为0
startUnloadingTransport = 开始卸载单位
startingHeightOffset = 创建时高度偏移
stayNeutral = 保持中立
stopLastAnimation = 停止最后动画
stopTargetingAfterFiring = 自动停火
streamingCost = 流式造价
strictLevel = 严格级别
stripIndex = 图像集
sweepOffset = 扫描偏移
sweepOffsetFromTargetRadius = 扫描偏移目标半径
sweepSpeed = 扫描速度
switchPriceWithStreamingCost = 切换价格为流造价
switchToAggressiveTeam = 切换至侵略性队伍
switchToNeutralTeam = 切换至中立队伍
switchtoteam = 切换至特定队伍
takeResources = 提取资源
takeResources_directTransferStoppingAtZero = 提取资源直接转换至零
takeResources_discardCollected = 提取资源删除
takeResources_excludeUnitsWithTheseResources = 提取资源排除资源
takeResources_excludeUnitsWithoutAllResources = 提取资源排除不足
takeResources_excludeUnitsWithoutCustomTarget1EqualTo = 提取资源没有自定义目标为
takeResources_excludeUnitsWithoutTags = 提取资源标签
takeResources_includeParent = 提取资源包括父单位或载具
takeResources_includeReference = 提取资源包括引用
takeResources_includeUnitsInTransport = 提取资源包括载具内
takeResources_includeUnitsWithinRange = 提取资源范围
takeResources_includeUnitsWithinRange_team = 提取资源队伍
takeResources_keepResourcesOnTarget = 提取资源克隆
takeResources_maxUnits = 提取资源目标量
takeResources_saveFirstUnitToCustomTarget1 = 提取资源保存第一个单元自定义目标1
takeResources_saveFirstUnitToCustomTarget2 = 提取资源保存第一个单元自定义目标2
takeResources_triggerActionIfAnyCollected = 提取资源成功触发
takeResources_triggerActionIfNoneCollected = 提取资源失败触发
targetGround = 目标为地面
targetGroundHeightOffset = 目标为地面高度偏移
targetGroundSpread = 目标为地面散布
targetGround_includeTargetHeight = 目标为地面包括目标高度
targetHeight = 到达高度
targetHeightDrift = 高度浮动
targetSpeed = 到达速度
teamColorRatio = 队伍色相
teamColorRatio_sourceRatio = 阵营色色相比例
teamColoringMode = 阵营色模式
teamColors = 阵营色
teamColorsOnTurret = 炮塔使用队伍色
teamColorsUseHue = 阵营色色相
tech = 科技
techLevel = 科技等级
teleportSource = 传送
temporarilyAddTags = 临时标签添加
temporarilyRemoveTags = 临时标签删除
textAddUnitName = 从单元添加名称
textPostFix = 文本动态更改
thisActionTarget = 当前动作目标
total_frames = 总帧数
trailEffect = 尾焰
trailEffectRate = 尾焰频率
transportSlotsNeeded = 运输占用位置
transportUnitsAddUnloadOption = 载具显示卸载按钮
transportUnitsBlockAirAndWaterUnits = 禁止运输空军和海军
transportUnitsBlockOtherTransports = 载具禁止装载其它载具
transportUnitsCanUnloadUnits = 载具可以卸载单位
transportUnitsEachUnitAlwaysUsesSingleSlot = 载员只占用一个槽位
transportUnitsHealBy = 载具治疗内部单位速度
transportUnitsKeepBuiltUnits = 单位建造完成时保留在载具内
transportUnitsKillOnDeath = 载具内单位和载具一同死亡
transportUnitsOnTeamChangeKeepCurrentTeam = 转换所属时保留内部单位所属
transportUnitsRequireMovementType = 被运输单位类型限制
transportUnitsRequireTag = 被运输单位需要标签
transportUnitsUnloadDelayBetweenEachUnit = 载具卸载时间间隔
transportedUnitsToTransfer = 载员至载具
transporting = 运输
turnAcceleration = 转弯加速度
turnSpeed = 转弯速度
turnSpeedAcceleration = 炮塔旋转加速度
turnSpeedDeceleration = 炮塔旋转减速度
turnSpeedWhenNear = 靠近时转弯速度
turretMultiTargeting = 每个炮塔向不同目标射击
turretRotateWithBody = 炮塔随主体旋转
turretSize = 炮塔大小
turretTurnSpeed = 炮塔转速
uiTargetRadius = 为目标时半径
unitShownInUI = UI中显示的单位
unitShownInUIWithHpBar = 单元在UI显示Hp条
unitShownInUIWithProgressBar = 单元在UI显示进度条
unitsSpawnedOnDeath = 死亡产生单位
unitsSpawnedOnDeath_setToTeamOfLastAttacker = 死亡产生单位所属
unloadUpToXUnitsAndGiveAttackOrder = 卸载单位并赋予攻击目标
unloadUpToXUnitsFromSource = 卸载单位至命中地
unsetFlag = 取消标志
upgradedFrom = 升级自
useAsAttacker = 用作攻击者
useAsBuilder = 用作建造者
useAsHarvester = 用作采集
useAsTransport = 用作运输
warmup = 预热
warmupCallDownRate = 预热下降速度
warmupNoReset = 预热不重置
warmupShootDelayTransfer = 开火间隔过渡
warmupStartEffect = 预热效果
whenBeingBuiltMakeTransparentTill = 建造时透明度
whenBuilding_cannotMove = 建造时无法移动
whenBuilding_playAnimation = 建造时播放动画
whenBuilding_rotateTo = 建造时旋转
whenBuilding_rotateTo_aimAtActionTarget = 建造时转向瞄准目标
whenBuilding_rotateTo_orBackwards = 建造时旋转或反转
whenBuilding_rotateTo_rotateTurretX = 建造时转向指定炮塔
whenBuilding_rotateTo_waitTillRotated = 建造时需等待旋转完成
whenBuilding_temporarilyConvertTo = 建造时临时转换为
whenBuilding_triggerAction = 建造时触发动作
whenUsingAsHarvester_includeOtherHarvesterCounts = 是否算在采集者计数中
whenUsingAsHarvester_recommendedGlobal = 全地图推荐采集者数量
whenUsingAsHarvester_recommendedInEachBase = 每个基地此采集者数量
whileNeutralConvertToTransportedTeam = 中立时转换为载员队伍
whileNeutralTransportAnyTeam = 中立时可装载任意所属单位
withTag = 需标签
withinRange = 范围内
withinSeconds = 指定时间内
wobbleAmplitude = 摆动幅度
wobbleFrequency = 摆动频率
xOffsetAbsolute = X轴绝对偏移
xOffsetAbsoluteRandom = X绝对随机偏移量
xOffsetRelative = X轴相对偏移
xOffsetRelativeRandom = X相对随机偏移量
xSpeedAbsolute = X绝对速度
xSpeedAbsoluteRandom = X随机绝对速度
xSpeedRelative = X相对速度
xSpeedRelativeRandom = X随机相对速度
yOffsetAbsolute = Y轴绝对偏移
yOffsetAbsoluteRandom = Y绝对随机偏移量
yOffsetRelative = Y轴相对偏移
yOffsetRelativeRandom = Y相对随机偏移量
ySpeedAbsolute = Y绝对速度
ySpeedAbsoluteRandom = Y随机绝对速度
ySpeedRelative = Y相对速度
ySpeedRelativeRandom = Y随机相对速度
zonemarker = 区域标记
